%%%%%%%%%%%%%%%%%%%@@%%%%%%%%%%%%%%%%%%@
%@@@@@@@@@@@@@@@@@@%@@@@@@@@@@@@@@@@@@@%
%@@@@@@@@@@@@@@@@@@%@@@@@@@@@@@@@@@@@@@%
%@@@@@@@@@@@@@@@%@@%@@@@@@@@@%@@%@@@%@@%
%@@@@@@@@@@@@@@@%@@%@@@@@@@@@%@@%@@@%@@%
%@@@%%%%@@@%%%%%@@@@%@@@%%%%%@@@@%%%@@@%
%@@@@@@@@@@@@@@@@@@@@@@@@@@@@@@@@@@@@@@%
%@@@@@@@@@@@@@@@@@@@@@@@@@@@@@@@@@@@@@@%
%@@@@@@@@@@@@@@%@@@@@@@@@@@@@%@@%@@@%@@%
%@@@@@@@@@@@@@@@@@@%@@@@@@@@@%@@@@@@@@@%
%@@@@@@@@@@@@@@@@@@%@@@@@@@@@%@@@@@@@@@%
%@@@@@@@@@@@%@@@@@@%@@@@@@@@@%@@@@@@@@@%
@%%%%%%@@@@@@@@@%@@%@@@@@@@@@%@@%%%%%%%@
@@@@@@@%@@@@%@@@@@@@@@@@@@@@@%@@%@@@@@@@
@@@@@@@%@@@@@@@@@@@@@@@@@@@@@%@@%@@@@@@@
@@@@@@@%@@@@@@@@@@@@@@@@@@@@@%@@%@@@@@@@
%%%%%%%@@@@@@@@%@@@@@@@@%@@@@%@@%%%%%%%%
@@@@@@@@@@@@@@@%@@@@@@@@%@@@@@@@@@@@@@@@
@@@@@@@@@@@@@@@%@@@@@@@@%@@@@@@@@@@@@@@@
%%%%%%%%@@@%@@@%@@@@@@@@%@@@%@@@@%%%%%%%
@@@@@@@%@@@@@@@%%%%%%%%%%@@@@%@@%@@@@@@@
@@@@@@@%@@@@@@@@@@@@@@@@@@@@@%@@%@@@@@@@
@@@@@@@%@@@@@@@@@@@@@@@@@@@@@%@@%@@@@@@@
@@@@@@@%@@@@@@@%@@@@@@@@@@@@@%@@%@@@@@@@
%@@@@@@@@@@@@@@@@@@%@@@@@@@@@@@@@@@@@@@@
%@@@@@@@@@@@@@@@@@@%@@@@@@@@@@@@@@@@@@@%
%@@@@@@@@@@@@@@@@@@%@@@@@@@@@@@@@@@@@@@%
%@@@@@@@@@@@@@@@%@@%@@@@@@@@@%@@%@@@%@@%
%@@@@@@@@@@@@@@@@@@@@@@@@@@@@@@@%@@@@@@%
%@@@@@@@@@@@@@@@@@@@@@@@@@@@@@@@%@@@@@@%
%@@@@@@@@@@@@@@@@@@@@@@@@@@@@@@@%@@@@@@@
%@@%@@@@@@@@@@@%@@@@@@@@@@@@@%@@%%@@@@@@
%@@@@@@@@@@@@@@@@@@%@@@@@@@@@%@@@@@@@@@%
%@@@@@@@@@@@@@@@@@@%@@@@@@@@@%@@@@@@@@@%
%@@@%%%%%%%@@%%%@@@%@@@@%%%%@@%%%%%%@@@%
%@@@%%%%%%%%%%%%@@@@%@@@%%%%%%%%%%%%@@@%
%@@@@@@@@@@@@@@@@@@@@@@@@@@@@@@@@@@@@@@%
%@@@@@@@@@@@@@@@@@@@@@@@@@@@@@@@@@@@@@@%
@%%%%%%%%%%%%%%%%%%%%%%%%%%%%%%%%%%%%%%%