┌────────────┐┌────────────┐
│············││············│
│·┌──┐·┌───┐·││·┌───┐·┌──┐·│
│*│  │·│   │·││·│   │·│  │*│
│·└──┘·└───┘·└┘·└───┘·└──┘·│
│··························│
│·┌──┐·┌┐·┌──────┐·┌┐·┌──┐·│
│·└──┘·││·└──┐┌──┘·││·└──┘·│
│······││····││····││······│
└────┐·│└──┐ ││ ┌──┘│·┌────┘
     │·│┌──┘ └┘ └──┐│·│
     │·││··········││·│
     │·││ ┌──══──┐ ││·│
─────┘·└┘ │      │ └┘·└─────
X     ·   │IIPPCC│   ·     X
─────┐·┌┐ │      │ ┌┐·┌─────
     │·││ └──────┘ ││·│
     │·││··········││·│
     │·││ ┌──────┐ ││·│
┌────┘·└┘ └──┐┌──┘ └┘·└────┐
│············││············│
│·┌──┐·┌───┐·││·┌───┐·┌──┐·│
│·└─┐│·└───┘·└┘·└───┘·│┌─┘·│
│*··││·······p········││··*│
└─┐·││·┌┐·┌──────┐·┌┐·││·┌─┘
┌─┘·└┘·││·└──┐┌──┘·││·└┘·└─┐
│······││····││····││······│
│·┌────┘└──┐·││·┌──┘└────┐·│
│·└────────┘·└┘·└────────┘·│
│··························│
└──────────────────────────┘