@@@@@@@@@@@@@@@@@@@@@@@@@@@@@@@@@@@@@@@@@@@@@@@@@@@@@@@@@@@@@@@@@@@@@@@@@@@@@@@@
@@@@@@@@@@@@@@@@@@@@@@@@@@@@@@@@@@@@@@@@@@@@@@@@@@@@@@@@@@@@@@@@@@@@@@@@@@@@@@@@
@@%%%%%%%%%%%%%%%%%%%%%%%%%%%%%%%%%%%%%%%%%%%%%%%%%%%%%%%%%%%%%%%%%%%%%%%%%%%%@@
%@%%%%%%%%%%%%%%%%%%%%%%%%%%%%%%%%%%%%@@@@%%%%%%%%%%%%%%%%%%%%%%%%%%%%%%%%%%%%@%
%%@@@@@@@@@@@@@@@@@@@@@@@@@@@@@@@@@@@@%@@%@@@@@@@@@@@@@@@@@@@@@@@@@@@@@@@@@@@@%%
%%@@@@@@@@@@@@@@@@@@@@@@@@@@@@@@@@@@@@%@@%@@@@@@@@@@@@@@@@@@@@@@@@@@@@@@@@@@@@%%
%%@@@@@@@@@@@@@@@@@@@@@@@@@@@@@@@@@@@@%@@%@@@@@@@@@@@@@@@@@@@@@@@@@@@@@@@@@@@@%%
%%@@@@@@@@@@@@@@@@@@@@@@@@@@@@@@@@@@@@%@@%@@@@@@@@@@@@@@@@@@@@@@@@@@@@@@@@@@@@%%
%%@@@@@@@@@@@@@@@@@@@@@@@@@@@@@@@@@@@@%@@%@@@@@@@@@@@@@@@@@@@@@@@@@@@@@@@@@@@@%%
%%@@@@@%@@@@@@@%@@@@@%@@@@@@@@@@%@@@@@%@@%@@@@@%@@@@@@@@@@%@@@@@%@@@@@@@%@@@@@%%
%%@@@@@%@@@@@@@%@@@@@%@@@@@@@@@@%@@@@@%@@%@@@@@%@@@@@@@@@@%@@@@@%@@@@@@@%@@@@@%%
%%@@@@@%@@@@@@@%@@@@@%@@@@@@@@@@%@@@@@%@@%@@@@@%@@@@@@@@@@%@@@@@%@@@@@@@%@@@@@%%
%%@@@@@%@@@@@@@%@@@@@%@@@@@@@@@@%@@@@@%@@%@@@@@%@@@@@@@@@@%@@@@@%@@@@@@@%@@@@@%%
%%@@@@@@%%%%%%%@@@@@@@%%%%%%%%%%@@@@@@@%%@@@@@@@%%%%%%%%%%@@@@@@@%%%%%%%@@@@@@%%
%%@@@@@@@@@@@@@@@@@@@@@@@@@@@@@@@@@@@@@@@@@@@@@@@@@@@@@@@@@@@@@@@@@@@@@@@@@@@@%%
%%@@@@@@@@@@@@@@@@@@@@@@@@@@@@@@@@@@@@@@@@@@@@@@@@@@@@@@@@@@@@@@@@@@@@@@@@@@@@%%
%%@@@@@@@@@@@@@@@@@@@@@@@@@@@@@@@@@@@@@@@@@@@@@@@@@@@@@@@@@@@@@@@@@@@@@@@@@@@@%%
%%@@@@@@@@@@@@@@@@@@@@@@@@@@@@@@@@@@@@@@@@@@@@@@@@@@@@@@@@@@@@@@@@@@@@@@@@@@@@%%
%%@@@@@@@@@@@@@@@@@@@@@@@@@@@@@@@@@@@@@@@@@@@@@@@@@@@@@@@@@@@@@@@@@@@@@@@@@@@@%%
%%@@@@@%@@@@@@@%@@@@@%@@@@@@@@%@@@@@@@@@@@@@@@@@@%@@@@@@@@%@@@@@%@@@@@@@%@@@@@%%
%%@@@@@%@@@@@@@%@@@@@%@@@@@@@@%@@@@@@@@@@@@@@@@@@%@@@@@@@@%@@@@@%@@@@@@@%@@@@@%%
%%@@@@@@@@@@@@@@@@@@@%@@@@@@@@@@@@@@@@%@@%@@@@@@@@@@@@@@@@%@@@@@@@@@@@@@@@@@@@%%
%%@@@@@@@@@@@@@@@@@@@%@@@@@@@@@@@@@@@@%@@%@@@@@@@@@@@@@@@@%@@@@@@@@@@@@@@@@@@@%%
%%@@@@@@@@@@@@@@@@@@@%@@@@@@@@@@@@@@@@%@@%@@@@@@@@@@@@@@@@%@@@@@@@@@@@@@@@@@@@%%
%%@@@@@@@@@@@@@@@@@@@%@@@@@@@@@@@@@@@@%@@%@@@@@@@@@@@@@@@@%@@@@@@@@@@@@@@@@@@@%%
%%@@@@@@@@@@@@@@@@@@@%@@%@@@@@@@@@@@@@%@@%@@@@@@@@@@@@@%@@%@@@@@@@@@@@@@@@@@@@%%
%@%%%%%%%%%%%%%@@@@@@%@@@%%%%%%%@@@@@@%@@%@@@@@@%%%%%%%@@@%@@@@@@%%%%%%%%%%%%%@%
@@%%%%%%%%%%%%@%@@@@@%@@@@@@@@@@%@@@@@%@@%@@@@@%@@@@@@@@@@%@@@@@%@%%%%%%%%%%%%@@
@@@@@@@@@@@@@@%%@@@@@%@@@%%%%%%%@@@@@@@%%@@@@@@@%%%%%%%@@@%@@@@@%%@@@@@@@@@@@@@@
@@@@@@@@@@@@@@%%@@@@@%@@%@@@@@@@@@@@@@@@@@@@@@@@@@@@@@@%@@%@@@@@%%@@@@@@@@@@@@@@
@@@@@@@@@@@@@@%%@@@@@%@@@@@@@@@@@@@@@@@@@@@@@@@@@@@@@@@@@@%@@@@@%%@@@@@@@@@@@@@@
@@@@@@@@@@@@@@%%@@@@@%@@@@@@@@@@@@@@@@@@@@@@@@@@@@@@@@@@@@%@@@@@%%@@@@@@@@@@@@@@
@@@@@@@@@@@@@@%%@@@@@%@@@@@@@@@@@@@@@@@@@@@@@@@@@@@@@@@@@@%@@@@@%%@@@@@@@@@@@@@@
@@@@@@@@@@@@@@%%@@@@@%@@@@@@@@@@@@@@@@@@@@@@@@@@@@@@@@@@@@%@@@@@%%@@@@@@@@@@@@@@
@@@@@@@@@@@@@@%%@@@@@%@@@@@@@@%%%%%%%@@@@@@%%%%%%%@@@@@@@@%@@@@@%%@@@@@@@@@@@@@@
%%%%%%%%%%%%%%@%@@@@@%@@@@@@@@%%@@@@@@@@@@@@@@@@%%@@@@@@@@%@@@@@%@%%%%%%%%%%%%%%
@@@@@@@@@@@@@@@@@@@@@@@@@@@@@@%@@@@@@@@@@@@@@@@@@%@@@@@@@@@@@@@@@@@@@@@@@@@@@@@@
@@@@@@@@@@@@@@@@@@@@@@@@@@@@@@%%@@@@@@@@@@@@@@@@%%@@@@@@@@@@@@@@@@@@@@@@@@@@@@@@
@@@@@@@@@@@@@@@@@@@@@@@@@@@@@@%%@@@@@@@@@@@@@@@@%%@@@@@@@@@@@@@@@@@@@@@@@@@@@@@@
@@@@@@@@@@@@@@@@@@@@@@@@@@@@@@%%@@@@@@@@@@@@@@@@%%@@@@@@@@@@@@@@@@@@@@@@@@@@@@@@
@@@@@@@@@@@@@@@@@@@@@@@@@@@@@@%%@@@@@@@@@@@@@@@@%%@@@@@@@@@@@@@@@@@@@@@@@@@@@@@@
%%%%%%%%%%%%%%%@@@@@@@%%@@@@@@%%@@@@@@@@@@@@@@@@%%@@@@@@%%@@@@@@@%%%%%%%%%%%%%%%
%%%%%%%%%%%%%%@%@@@@@%@@@@@@@@%%%%%%%%%%%%%%%%%%%%@@@@@@@@%@@@@@%@%%%%%%%%%%%%%%
@@@@@@@@@@@@@@%%@@@@@%@@@@@@@@%%%%%%%%%%%%%%%%%%%%@@@@@@@@%@@@@@%%@@@@@@@@@@@@@@
@@@@@@@@@@@@@@%%@@@@@%@@@@@@@@@@@@@@@@@@@@@@@@@@@@@@@@@@@@%@@@@@%%@@@@@@@@@@@@@@
@@@@@@@@@@@@@@%%@@@@@%@@@@@@@@@@@@@@@@@@@@@@@@@@@@@@@@@@@@%@@@@@%%@@@@@@@@@@@@@@
@@@@@@@@@@@@@@%%@@@@@%@@@@@@@@@@@@@@@@@@@@@@@@@@@@@@@@@@@@%@@@@@%%@@@@@@@@@@@@@@
@@@@@@@@@@@@@@%%@@@@@%@@@@@@@@@@@@@@@@@@@@@@@@@@@@@@@@@@@@%@@@@@%%@@@@@@@@@@@@@@
@@@@@@@@@@@@@@%%@@@@@%@@@@@@@@@@@@@@@@@@@@@@@@@@@@@@@@@@@@%@@@@@%%@@@@@@@@@@@@@@
@@@@@@@@@@@@@@%%@@@@@%@@@@@@@@%@@@@@@@@@@@@@@@@@@%@@@@@@@@%@@@@@%%@@@@@@@@@@@@@@
@%%%%%%%%%%%%%@%@@@@@%@@@@@@@@%@@@@@@@@@@@@@@@@@@%@@@@@@@@%@@@@@%@%%%%%%%%%%%%%@
%@@@@@@@@@@@@@@@@@@@@@@@@@@@@@@@@@@@@@%@@%@@@@@@@@@@@@@@@@@@@@@@@@@@@@@@@@@@@@@%
%%@@@@@@@@@@@@@@@@@@@@@@@@@@@@@@@@@@@@%@@%@@@@@@@@@@@@@@@@@@@@@@@@@@@@@@@@@@@@%%
%%@@@@@@@@@@@@@@@@@@@@@@@@@@@@@@@@@@@@%@@%@@@@@@@@@@@@@@@@@@@@@@@@@@@@@@@@@@@@%%
%%@@@@@@@@@@@@@@@@@@@@@@@@@@@@@@@@@@@@%@@%@@@@@@@@@@@@@@@@@@@@@@@@@@@@@@@@@@@@%%
%%@@@@@@@@@@@@@@@@@@@@@@@@@@@@@@@@@@@@%@@%@@@@@@@@@@@@@@@@@@@@@@@@@@@@@@@@@@@@%%
%%@@@@@@%%%%%%%@@@@@@@%%%%%%%%%%@@@@@@%@@%@@@@@@%%%%%%%%%%@@@@@@@%%%%%%%@@@@@@%%
%%@@@@@%@@@@@@@%@@@@@%@@@@@@@@@@%@@@@@%@@%@@@@@%@@@@@@@@@@%@@@@@%@@@@@@@%@@@@@%%
%%@@@@@@%%%%@@@%@@@@@@%%%%%%%%%%@@@@@@@%%@@@@@@@%%%%%%%%%%@@@@@@%@@@%%%%@@@@@@%%
%%@@@@@@@@@@@@@%@@@@@@@@@@@@@@@@@@@@@@@@@@@@@@@@@@@@@@@@@@@@@@@@%@@@@@@@@@@@@@%%
%%@@@@@@@@@@@@@%@@@@@@@@@@@@@@@@@@@@@@@@@@@@@@@@@@@@@@@@@@@@@@@@%@@@@@@@@@@@@@%%
%%@@@@@@@@@@@@@%@@@@@@@@@@@@@@@@@@@@@@@@@@@@@@@@@@@@@@@@@@@@@@@@%@@@@@@@@@@@@@%%
%%@@@@@@@@@@@@@%@@@@@@@@@@@@@@@@@@@@@@@@@@@@@@@@@@@@@@@@@@@@@@@@%@@@@@@@@@@@@@%%
%@@@@@@@@@@@@@@%@@@@@@@@@@@@@@@@@@@@@@@@@@@@@@@@@@@@@@@@@@@@@@@@%@@@@@@@@@@@@@@%
%@@@@@%@@@@@@@@%@@@@@%@@@@@@@@%@@@@@@@@@@@@@@@@@@%@@@@@@@@%@@@@@%@@@@@@@@%@@@@@%
%@@@@@%@@@@@@%@%@@@@@%@@@@@@@@%@@@@@@@@@@@@@@@@@@%@@@@@@@@%@@@@@%@%@@@@@@%@@@@@%
%@@@@@@@@@@@@@@@@@@@@%@@@@@@@@@@@@@@@@%@@%@@@@@@@@@@@@@@@@%@@@@@@@@@@@@@@@@@@@@%
%%@@@@@@@@@@@@@@@@@@@%@@@@@@@@@@@@@@@@%@@%@@@@@@@@@@@@@@@@%@@@@@@@@@@@@@@@@@@@%%
%%@@@@@@@@@@@@@@@@@@@%@@@@@@@@@@@@@@@@%@@%@@@@@@@@@@@@@@@@%@@@@@@@@@@@@@@@@@@@%%
%%@@@@@@@@@@@@@@@@@@@%@@@@@@@@@@@@@@@@%@@%@@@@@@@@@@@@@@@@%@@@@@@@@@@@@@@@@@@@%%
%%@@@@@@@@@@@@@@@@@@@%@@%@@@@@@@@@@@@@%@@%@@@@@@@@@@@@@%@@%@@@@@@@@@@@@@@@@@@@%%
%%@@@@@@%%%%%%%%%%%%%@@@@%%%%%%%@@@@@@%@@%@@@@@@%%%%%%%@@@@%%%%%%%%%%%%%@@@@@@%%
%%@@@@@%@@@@@@@@@@@@@@@@@@@@@@@@%@@@@@%@@%@@@@@%@@@@@@@@@@@@@@@@@@@@@@@@%@@@@@%%
%%@@@@@@%%%%%%%%%%%%%%%%%%%%%%%%@@@@@@@%%@@@@@@@%%%%%%%%%%%%%%%%%%%%%%%%@@@@@@%%
%%@@@@@@@@@@@@@@@@@@@@@@@@@@@@@@@@@@@@@@@@@@@@@@@@@@@@@@@@@@@@@@@@@@@@@@@@@@@@%%
%%@@@@@@@@@@@@@@@@@@@@@@@@@@@@@@@@@@@@@@@@@@@@@@@@@@@@@@@@@@@@@@@@@@@@@@@@@@@@%%
%%@@@@@@@@@@@@@@@@@@@@@@@@@@@@@@@@@@@@@@@@@@@@@@@@@@@@@@@@@@@@@@@@@@@@@@@@@@@@%%
%%@@@@@@@@@@@@@@@@@@@@@@@@@@@@@@@@@@@@@@@@@@@@@@@@@@@@@@@@@@@@@@@@@@@@@@@@@@@@%%
%@@@@@@@@@@@@@@@@@@@@@@@@@@@@@@@@@@@@@@@@@@@@@@@@@@@@@@@@@@@@@@@@@@@@@@@@@@@@@@%
@%%%%%%%%%%%%%%%%%%%%%%%%%%%%%%%%%%%%%%%%%%%%%%%%%%%%%%%%%%%%%%%%%%%%%%%%%%%%%%@